002000100001111111-
101010101101111111-
101010101101111111-
101010101101111111-
101010101101111111-
101010101101111111-
100010001100111111-
111111111111111111

